City	State
Prattville	AL
Daphne	AL
Anniston	AL
Enterprise	AL
Dothan	AL
Gadsden	AL
Bessemer	AL
Homewood	AL
Mountain Brook	AL
Florence	AL
Auburn	AL
Opelika	AL
Phenix City	AL
Athens	AL
Huntsville	AL
Madison	AL
Decatur	AL
Albertville	AL
Mobile	AL
Prichard	AL
Montgomery	AL
Alabaster	AL
Pelham	AL
Birmingham	AL
Hoover	AL
Vestavia Hills	AL
Trussville	AL
Oxford	AL
Tuscaloosa	AL
Northport	AL
Anchorage	AK
Fairbanks	AK
Badger	AK
Juneau	AK
Sierra Vista	AZ
Flagstaff	AZ
Phoenix	AZ
Mesa	AZ
Chandler	AZ
Gilbert	AZ
Glendale	AZ
Scottsdale	AZ
Tempe	AZ
Surprise	AZ
Avondale	AZ
Goodyear	AZ
Buckeye	AZ
Sun City	AZ
El Mirage	AZ
Sun City West	AZ
Anthem	AZ
Fountain Hills	AZ
Peoria	AZ
Lake Havasu City	AZ
Bullhead City	AZ
Kingman	AZ
Tucson	AZ
Casas Adobes	AZ
Catalina Foothills	AZ
Oro Valley	AZ
Drexel Heights	AZ
Sahuarita	AZ
Green Valley	AZ
San Tan Valley	AZ
Casa Grande	AZ
Maricopa	AZ
Florence	AZ
Apache Junction	AZ
Queen Creek	AZ
Marana	AZ
Nogales	AZ
Prescott Valley	AZ
Prescott	AZ
Yuma	AZ
San Luis	AZ
Fortuna Foothills	AZ
Rogers	AR
Bentonville	AR
Bella Vista	AR
Jonesboro	AR
Van Buren	AR
West Memphis	AR
Conway	AR
Hot Springs	AR
Paragould	AR
Pine Bluff	AR
Cabot	AR
Texarkana	AR
Russellville	AR
Little Rock	AR
North Little Rock	AR
Sherwood	AR
Jacksonville	AR
Benton	AR
Fort Smith	AR
Fayetteville	AR
Springdale	AR
Searcy	AR
Oakland	CA
Fremont	CA
Hayward	CA
Berkeley	CA
San Leandro	CA
Livermore	CA
Pleasanton	CA
Alameda	CA
Union City	CA
Castro Valley	CA
Dublin	CA
Newark	CA
San Lorenzo	CA
Ashland	CA
Chico	CA
Paradise	CA
Concord	CA
Antioch	CA
Richmond	CA
San Ramon	CA
Pittsburg	CA
Walnut Creek	CA
Brentwood	CA
Danville	CA
Oakley	CA
Martinez	CA
Pleasant Hill	CA
San Pablo	CA
Lafayette	CA
Hercules	CA
El Cerrito	CA
Bay Point	CA
El Dorado Hills	CA
South Lake Tahoe	CA
Fresno	CA
Clovis	CA
Reedley	CA
Sanger	CA
Selma	CA
Eureka	CA
El Centro	CA
Calexico	CA
Brawley	CA
Bakersfield	CA
Delano	CA
Oildale	CA
Ridgecrest	CA
Wasco	CA
Arvin	CA
Hanford	CA
Lemoore	CA
Corcoran	CA
Los Angeles	CA
Long Beach	CA
Glendale	CA
Santa Clarita	CA
Lancaster	CA
Palmdale	CA
Pomona	CA
Torrance	CA
Pasadena	CA
East Los Angeles	CA
El Monte	CA
Downey	CA
Inglewood	CA
West Covina	CA
Norwalk	CA
Burbank	CA
Compton	CA
South Gate	CA
Carson	CA
Santa Monica	CA
Hawthorne	CA
Whittier	CA
Alhambra	CA
Lakewood	CA
Bellflower	CA
Baldwin Park	CA
Lynwood	CA
Redondo Beach	CA
Pico Rivera	CA
Montebello	CA
Florence-Graham	CA
Monterey Park	CA
Gardena	CA
Huntington Park	CA
Arcadia	CA
South Whittier	CA
Diamond Bar	CA
Paramount	CA
Hacienda Heights	CA
Rosemead	CA
Glendora	CA
Rowland Heights	CA
Cerritos	CA
Azusa	CA
La Mirada	CA
Covina	CA
Altadena	CA
Bell Gardens	CA
Rancho Palos Verdes	CA
La Puente	CA
San Gabriel	CA
Culver City	CA
Monrovia	CA
Temple City	CA
Claremont	CA
West Hollywood	CA
Bell	CA
Manhattan Beach	CA
Beverly Hills	CA
San Dimas	CA
Lawndale	CA
La Verne	CA
Westmont	CA
Walnut	CA
Maywood	CA
West Whittier-Los Nietos	CA
South Pasadena	CA
San Fernando	CA
Calabasas	CA
Cudahy	CA
West Puente Valley	CA
Valinda	CA
Lennox	CA
Duarte	CA
West Rancho Dominguez	CA
South San Jose Hills	CA
Agoura Hills	CA
Willowbrook	CA
South El Monte	CA
Lomita	CA
West Carson	CA
La Cañada Flintridge	CA
La Crescenta-Montrose	CA
Madera	CA
San Rafael	CA
Novato	CA
Merced	CA
Los Banos	CA
Atwater	CA
Salinas	CA
Seaside	CA
Monterey	CA
Soledad	CA
Marina	CA
Napa	CA
American Canyon	CA
Anaheim	CA
Santa Ana	CA
Irvine	CA
Huntington Beach	CA
Garden Grove	CA
Orange	CA
Fullerton	CA
Costa Mesa	CA
Mission Viejo	CA
Westminster	CA
Newport Beach	CA
Buena Park	CA
Lake Forest	CA
Tustin	CA
Yorba Linda	CA
Laguna Niguel	CA
San Clemente	CA
La Habra	CA
Fountain Valley	CA
Placentia	CA
Aliso Viejo	CA
Rancho Santa Margarita	CA
Cypress	CA
Brea	CA
Stanton	CA
San Juan Capistrano	CA
Dana Point	CA
Laguna Hills	CA
Ladera Ranch	CA
North Tustin	CA
Seal Beach	CA
Laguna Beach	CA
Roseville	CA
Rocklin	CA
Lincoln	CA
Granite Bay	CA
Riverside	CA
Moreno Valley	CA
Corona	CA
Temecula	CA
Murrieta	CA
Jurupa Valley	CA
Indio	CA
Menifee	CA
Hemet	CA
Perris	CA
Lake Elsinore	CA
Eastvale	CA
Cathedral City	CA
Palm Desert	CA
Palm Springs	CA
San Jacinto	CA
Coachella	CA
Beaumont	CA
La Quinta	CA
Wildomar	CA
Banning	CA
Desert Hot Springs	CA
French Valley	CA
Norco	CA
Temescal Valley	CA
Sacramento	CA
Elk Grove	CA
Arden-Arcade	CA
Citrus Heights	CA
Folsom	CA
Rancho Cordova	CA
Carmichael	CA
Florin	CA
Antelope	CA
North Highlands	CA
Orangevale	CA
Foothill Farms	CA
Fair Oaks	CA
Vineyard	CA
Galt	CA
Rosemont	CA
Hollister	CA
San Bernardino	CA
Fontana	CA
Rancho Cucamonga	CA
Ontario	CA
Victorville	CA
Rialto	CA
Hesperia	CA
Chino	CA
Chino Hills	CA
Upland	CA
Apple Valley	CA
Redlands	CA
Highland	CA
Colton	CA
Yucaipa	CA
Montclair	CA
Adelanto	CA
Twentynine Palms	CA
Bloomington	CA
Loma Linda	CA
Barstow	CA
Yucca Valley	CA
San Diego	CA
Chula Vista	CA
Oceanside	CA
Escondido	CA
Carlsbad	CA
El Cajon	CA
Vista	CA
San Marcos	CA
Encinitas	CA
National City	CA
La Mesa	CA
Santee	CA
Poway	CA
La Presa	CA
Fallbrook	CA
Spring Valley	CA
Imperial Beach	CA
Lemon Grove	CA
Coronado	CA
Ramona	CA
Rancho San Diego	CA
Lakeside	CA
Casa de Oro-Mount Helix	CA
Winter Gardens	CA
San Francisco	CA
Stockton	CA
Tracy	CA
Manteca	CA
Lodi	CA
Lathrop	CA
San Luis Obispo	CA
El Paso de Robles (Paso Robles)	CA
Atascadero	CA
Daly City	CA
San Mateo	CA
Redwood City	CA
South San Francisco	CA
San Bruno	CA
Pacifica	CA
Foster City	CA
Menlo Park	CA
Burlingame	CA
San Carlos	CA
East Palo Alto	CA
Belmont	CA
Millbrae	CA
Santa Maria	CA
Santa Barbara	CA
Lompoc	CA
Goleta	CA
Orcutt	CA
Isla Vista	CA
San Jose	CA
Sunnyvale	CA
Santa Clara	CA
Mountain View	CA
Milpitas	CA
Palo Alto	CA
Cupertino	CA
Gilroy	CA
Morgan Hill	CA
Campbell	CA
Saratoga	CA
Los Gatos	CA
Los Altos	CA
Santa Cruz	CA
Watsonville	CA
Redding	CA
Vallejo	CA
Fairfield	CA
Vacaville	CA
Suisun City	CA
Benicia	CA
Santa Rosa	CA
Petaluma	CA
Rohnert Park	CA
Windsor	CA
Modesto	CA
Turlock	CA
Ceres	CA
Riverbank	CA
Oakdale	CA
Patterson	CA
Yuba City	CA
Visalia	CA
Tulare	CA
Porterville	CA
Dinuba	CA
Oxnard	CA
Thousand Oaks	CA
Simi Valley	CA
San Buenaventura (Ventura)	CA
Camarillo	CA
Moorpark	CA
Santa Paula	CA
Port Hueneme	CA
Davis	CA
Woodland	CA
West Sacramento	CA
Commerce City	CO
Aurora	CO
Thornton	CO
Northglenn	CO
Brighton	CO
Centennial	CO
Englewood	CO
Boulder	CO
Lafayette	CO
Louisville	CO
Longmont	CO
Erie	CO
Broomfield	CO
Denver	CO
Highlands Ranch	CO
Castle Rock	CO
Parker	CO
Colorado Springs	CO
Security-Widefield	CO
Fountain	CO
Lakewood	CO
Dakota Ridge	CO
Ken Caryl	CO
Wheat Ridge	CO
Golden	CO
Arvada	CO
Westminster	CO
Columbine	CO
Littleton	CO
Fort Collins	CO
Loveland	CO
Grand Junction	CO
Clifton	CO
Pueblo	CO
Pueblo West	CO
Greeley	CO
Evans	CO
Windsor	CO
Bridgeport	CT
Bridgeport (Town)	CT
Stamford	CT
Stamford (Town)	CT
Norwalk	CT
Norwalk (Town)	CT
Danbury	CT
Danbury (Town)	CT
Greenwich	CT
Fairfield	CT
Stratford	CT
Stratford (CDP)	CT
Shelton	CT
Shelton (Town)	CT
Trumbull	CT
Trumbull (CDP)	CT
Newtown (Town)	CT
Westport	CT
Westport (CDP)	CT
Ridgefield	CT
Darien	CT
Darien (CDP)	CT
New Canaan	CT
Hartford	CT
Hartford (Town)	CT
New Britain	CT
New Britain (Town)	CT
West Hartford (CDP)	CT
West Hartford	CT
Bristol	CT
Bristol (Town)	CT
Manchester	CT
East Hartford (CDP)	CT
East Hartford	CT
Enfield	CT
Southington	CT
Glastonbury	CT
Newington (CDP)	CT
Manchester (CDP)	CT
Newington	CT
Windsor	CT
Wethersfield (CDP)	CT
Wethersfield	CT
South Windsor	CT
Farmington	CT
Simsbury	CT
Bloomfield	CT
Berlin	CT
Rocky Hill	CT
Torrington	CT
Torrington (Town)	CT
New Milford	CT
Watertown	CT
Middletown	CT
Middletown (Town)	CT
New Haven	CT
New Haven (Town)	CT
Waterbury	CT
Waterbury (Town)	CT
Hamden	CT
Meriden	CT
Meriden (Town)	CT
West Haven	CT
West Haven (Town)	CT
Milford	CT
Milford (Town)	CT
Wallingford	CT
Naugatuck	CT
Naugatuck (Town)	CT
Cheshire	CT
East Haven (CDP)	CT
East Haven	CT
Branford	CT
North Haven (CDP)	CT
North Haven	CT
Guilford	CT
Norwich	CT
Norwich (Town)	CT
Groton (Town)	CT
New London	CT
New London (Town)	CT
Vernon	CT
Mansfield	CT
Windham	CT
Dover	DE
Wilmington	DE
Newark	DE
Middletown	DE
Washington	DC
Gainesville	FL
Panama City	FL
Lynn Haven	FL
Palm Bay	FL
Melbourne	FL
Titusville	FL
Merritt Island	FL
Rockledge	FL
West Melbourne	FL
Fort Lauderdale	FL
Pembroke Pines	FL
Hollywood	FL
Miramar	FL
Coral Springs	FL
Pompano Beach	FL
Davie	FL
Sunrise	FL
Plantation	FL
Deerfield Beach	FL
Lauderhill	FL
Weston	FL
Tamarac	FL
Coconut Creek	FL
Margate	FL
Oakland Park	FL
North Lauderdale	FL
Hallandale Beach	FL
Cooper City	FL
Lauderdale Lakes	FL
Dania Beach	FL
Parkland	FL
Port Charlotte	FL
Lakeside	FL
Fleming Island	FL
Oakleaf Plantation	FL
Golden Gate	FL
Immokalee	FL
Naples	FL
Jacksonville	FL
Jacksonville Beach	FL
Pensacola	FL
Ferry Pass	FL
Bellview	FL
Brent	FL
Ensley	FL
Palm Coast	FL
Spring Hill	FL
Tampa	FL
Brandon	FL
Town 'n' Country	FL
Riverview	FL
University	FL
Plant City	FL
Egypt Lake-Leto	FL
Valrico	FL
Carrollwood	FL
Lake Magdalene	FL
Temple Terrace	FL
Citrus Park	FL
East Lake-Orient Park	FL
Westchase	FL
Bloomingdale	FL
Keystone	FL
Palm River-Clair Mel	FL
Northdale	FL
Lutz	FL
Sun City Center	FL
Sebastian	FL
Vero Beach South	FL
Clermont	FL
Leesburg	FL
Cape Coral	FL
Lehigh Acres	FL
Fort Myers	FL
Bonita Springs	FL
North Fort Myers	FL
Estero	FL
Tallahassee	FL
Bradenton	FL
South Bradenton	FL
Ocala	FL
Palm City	FL
Miami	FL
Hialeah	FL
Miami Gardens	FL
Miami Beach	FL
Kendall	FL
Homestead	FL
North Miami	FL
Kendale Lakes	FL
Tamiami	FL
Doral	FL
The Hammocks	FL
Fountainebleau	FL
Coral Gables	FL
Country Club	FL
Cutler Bay	FL
North Miami Beach	FL
Kendall West	FL
Aventura	FL
South Miami Heights	FL
Richmond West	FL
Golden Glades	FL
West Little River	FL
Miami Lakes	FL
Westchester	FL
University Park	FL
Princeton	FL
Coral Terrace	FL
Palmetto Bay	FL
The Crossings	FL
Leisure City	FL
Hialeah Gardens	FL
Sunny Isles Beach	FL
Sweetwater	FL
Key West	FL
Wright	FL
Crestview	FL
Fort Walton Beach	FL
Orlando	FL
Alafaya	FL
Pine Hills	FL
Apopka	FL
Ocoee	FL
Winter Garden	FL
University	FL
Winter Park	FL
Meadow Woods	FL
Oak Ridge	FL
Hunters Creek	FL
Four Corners	FL
Kissimmee	FL
St. Cloud	FL
Buenaventura Lakes	FL
West Palm Beach	FL
Boca Raton	FL
Boynton Beach	FL
Delray Beach	FL
Jupiter	FL
Wellington	FL
Palm Beach Gardens	FL
Greenacres	FL
The Acreage	FL
Royal Palm Beach	FL
Lake Worth	FL
Riviera Beach	FL
Palm Springs	FL
Wesley Chapel	FL
Land O' Lakes	FL
Bayonet Point	FL
Holiday	FL
St. Petersburg	FL
Clearwater	FL
Largo	FL
Palm Harbor	FL
Pinellas Park	FL
Dunedin	FL
East Lake	FL
Tarpon Springs	FL
Lealman	FL
Lakeland	FL
Winter Haven	FL
Haines City	FL
Poinciana	FL
Navarre	FL
Pace	FL
North Port	FL
Sarasota	FL
Venice	FL
Sanford	FL
Altamonte Springs	FL
Oviedo	FL
Winter Springs	FL
Casselberry	FL
Wekiwa Springs	FL
Fruit Cove	FL
Palm Valley	FL
Port St. Lucie	FL
Fort Pierce	FL
The Villages	FL
Deltona	FL
Daytona Beach	FL
Port Orange	FL
Ormond Beach	FL
DeLand	FL
New Smyrna Beach	FL
Edgewater	FL
Cartersville	GA
Macon	GA
Statesboro	GA
Carrollton	GA
Savannah	GA
Pooler	GA
Woodstock	GA
Canton	GA
Athens	GA
Marietta	GA
Smyrna	GA
Mableton	GA
Kennesaw	GA
Acworth	GA
Martinez	GA
Evans	GA
Newnan	GA
Brookhaven	GA
Dunwoody	GA
Redan	GA
Chamblee	GA
Candler-McAfee	GA
Decatur	GA
Atlanta	GA
Albany	GA
Douglasville	GA
Peachtree City	GA
Rome	GA
Sandy Springs	GA
Johns Creek	GA
Alpharetta	GA
Milton	GA
East Point	GA
Union City	GA
Roswell	GA
Peachtree Corners	GA
Lawrenceville	GA
Duluth	GA
Sugar Hill	GA
Gainesville	GA
Stockbridge	GA
McDonough	GA
Hinesville	GA
Valdosta	GA
Columbus	GA
Warner Robins	GA
Augusta	GA
Griffin	GA
LaGrange	GA
Dalton	GA
Hilo	HI
Honolulu	HI
East Honolulu	HI
Pearl City	HI
Waipahu	HI
Kailua	HI
Kaneohe	HI
Mililani Town	HI
Ewa Gentry	HI
Mililani Mauka	HI
Kahului	HI
Kihei	HI
Boise City	ID
Meridian	ID
Eagle	ID
Idaho Falls	ID
Nampa	ID
Caldwell	ID
Coeur d'Alene	ID
Post Falls	ID
Moscow	ID
Rexburg	ID
Lewiston	ID
Pocatello	ID
Twin Falls	ID
Quincy	IL
Quincy (Township)	IL
Belvidere (Township)	IL
Belvidere	IL
Champaign	IL
Champaign City	IL
Cunningham	IL
Urbana	IL
Charleston (Township)	IL
Charleston	IL
Thornton (Township)	IL
Wheeling (Township)	IL
Worth (Township)	IL
Proviso	IL
Maine	IL
Schaumburg (Township)	IL
Palatine (Township)	IL
Lyons (Township)	IL
Bremen	IL
Niles (Township)	IL
Hanover	IL
Orland	IL
Elk Grove	IL
Leyden	IL
Bloom	IL
Northfield (Township)	IL
Cicero	IL
Cicero (Township)	IL
Rich	IL
Arlington Heights	IL
Evanston	IL
Evanston (Township)	IL
Palatine	IL
Skokie	IL
Des Plaines	IL
Oak Lawn	IL
New Trier	IL
Berwyn	IL
Berwyn (Township)	IL
Palos	IL
Mount Prospect	IL
Oak Park	IL
Oak Park (Township)	IL
Glenview	IL
Stickney (Township)	IL
Streamwood	IL
Park Ridge	IL
Calumet City	IL
Northbrook	IL
Chicago Heights	IL
Niles	IL
Burbank	IL
Lansing	IL
Oak Forest	IL
Wilmette	IL
Norwood Park	IL
Melrose Park	IL
Harvey	IL
Elmwood Park	IL
Rolling Meadows	IL
Maywood	IL
Blue Island	IL
Morton Grove	IL
Dolton	IL
South Holland	IL
Lemont (Township)	IL
Calumet	IL
Chicago	IL
Schaumburg	IL
Elmhurst	IL
Hanover Park	IL
Elk Grove Village	IL
Roselle	IL
Elgin	IL
Hoffman Estates	IL
Bartlett	IL
Buffalo Grove	IL
Wheeling	IL
Orland Park	IL
Tinley Park	IL
Homer Glen	IL
Park Forest	IL
Woodridge	IL
DeKalb (Township)	IL
DeKalb	IL
Downers Grove (Township)	IL
York	IL
Lisle (Township)	IL
Milton	IL
Bloomingdale (Township)	IL
Naperville (Township)	IL
Addison (Township)	IL
Wayne (Township)	IL
Wheaton	IL
Downers Grove	IL
Winfield (Township)	IL
Lombard	IL
Carol Stream	IL
Addison	IL
Glendale Heights	IL
Glen Ellyn	IL
West Chicago	IL
Westmont	IL
Lisle	IL
Darien	IL
Bloomingdale	IL
Villa Park	IL
Carbondale (Township)	IL
Aurora (Township)	IL
Elgin (Township)	IL
Dundee	IL
St. Charles (Township)	IL
Carpentersville	IL
Batavia (Township)	IL
Geneva (Township)	IL
South Elgin	IL
Rutland	IL
Geneva	IL
Sugar Grove (Township)	IL
St. Charles	IL
Batavia	IL
Algonquin	IL
Huntley	IL
Bourbonnais (Township)	IL
Kankakee (Township)	IL
Kankakee	IL
Oswego (Township)	IL
Bristol	IL
Aurora	IL
Joliet	IL
Plainfield	IL
Oswego	IL
Galesburg	IL
Galesburg City	IL
Waukegan (Township)	IL
Waukegan	IL
Vernon	IL
Avon	IL
Warren	IL
Libertyville (Township)	IL
Ela	IL
Lake Villa (Township)	IL
Shields	IL
Moraine	IL
Fremont	IL
West Deerfield	IL
Mundelein	IL
Gurnee	IL
Highland Park	IL
North Chicago	IL
Round Lake Beach	IL
Antioch (Township)	IL
Grant	IL
Vernon Hills	IL
Zion	IL
Zion (Township)	IL
Wauconda (Township)	IL
Grayslake	IL
Libertyville	IL
Decatur	IL
Decatur (Township)	IL
Edwardsville (Township)	IL
Collinsville (Township)	IL
Wood River (Township)	IL
Granite City	IL
Alton	IL
Alton (Township)	IL
Granite City (Township)	IL
Edwardsville	IL
Algonquin (Township)	IL
Grafton	IL
McHenry (Township)	IL
Crystal Lake	IL
Nunda	IL
Lake in the Hills	IL
McHenry	IL
Woodstock	IL
Dorr	IL
Bloomington	IL
Bloomington City	IL
Normal (Township)	IL
Normal	IL
Peoria	IL
Peoria City	IL
Moline	IL
Rock Island	IL
South Moline	IL
Moline (Township)	IL
Hampton (Township)	IL
East Moline	IL
Springfield	IL
Capital	IL
Belleville	IL
Belleville (Township)	IL
St. Clair	IL
Caseyville (Township)	IL
O'Fallon	IL
East St. Louis	IL
East St. Louis (Township)	IL
O'Fallon (Township)	IL
Centreville (Township)	IL
Collinsville	IL
Freeport	IL
Freeport (Township)	IL
Pekin (Township)	IL
Washington (Township)	IL
East Peoria	IL
Pekin	IL
Danville	IL
Danville (Township)	IL
Du Page	IL
Joliet (Township)	IL
Wheatland	IL
Plainfield (Township)	IL
Lockport (Township)	IL
Frankfort (Township)	IL
Troy	IL
New Lenox (Township)	IL
Romeoville	IL
Homer	IL
New Lenox	IL
Lockport	IL
Crete (Township)	IL
Crest Hill	IL
Naperville	IL
Bolingbrook	IL
Carbondale	IL
Rockford (Township)	IL
Harlem	IL
Machesney Park	IL
Loves Park	IL
Rockford	IL
Fort Wayne	IN
Wayne	IN
St. Joseph	IN
Aboite	IN
Washington	IN
Adams	IN
Perry	IN
Columbus (Township)	IN
Columbus	IN
Zionsville	IN
Jeffersonville (Township)	IN
Jeffersonville	IN
Clarksville	IN
Muncie	IN
Center	IN
Concord	IN
Elkhart	IN
Elkhart (Township)	IN
Goshen	IN
Osolo	IN
New Albany (Township)	IN
New Albany	IN
Marion	IN
Center	IN
Clay	IN
Carmel	IN
Fishers	IN
Fall Creek	IN
Noblesville	IN
Noblesville (Township)	IN
Washington	IN
Westfield	IN
Delaware	IN
Center	IN
Greenfield	IN
Washington	IN
Lincoln	IN
Plainfield	IN
Guilford	IN
Brownsburg	IN
Henry	IN
Kokomo	IN
Center	IN
Huntington (Township)	IN
Jackson	IN
Pleasant	IN
Greenwood	IN
White River	IN
Franklin	IN
Franklin (Township)	IN
Vincennes (Township)	IN
Wayne	IN
North	IN
Calumet	IN
Hammond	IN
Gary	IN
St. John (Township)	IN
Ross	IN
Hobart (Township)	IN
Merrillville	IN
Center	IN
Crown Point	IN
Schererville	IN
East Chicago	IN
Hobart	IN
Munster	IN
Highland	IN
Michigan City	IN
Michigan	IN
Center	IN
La Porte	IN
Shawswick	IN
Anderson (Township)	IN
Anderson	IN
Center	IN
Wayne	IN
Washington	IN
Lawrence (Township)	IN
Perry	IN
Warren	IN
Pike	IN
Franklin	IN
Lawrence	IN
Decatur	IN
Indianapolis	IN
Bloomington	IN
Perry	IN
Bloomington (Township)	IN
Union	IN
Portage (Township)	IN
Center	IN
Portage	IN
Valparaiso	IN
Westchester	IN
Addison	IN
South Bend	IN
Portage	IN
Penn	IN
Mishawaka	IN
Clay	IN
Granger	IN
Harris	IN
Lafayette	IN
Wabash	IN
Fairfield	IN
West Lafayette	IN
Wea	IN
Evansville	IN
Knight	IN
Center	IN
Pigeon	IN
Perry	IN
Terre Haute	IN
Harrison	IN
Ohio	IN
Wayne	IN
Richmond	IN
Waterloo	IA
Cedar Falls	IA
Mason City	IA
Clinton	IA
Urbandale	IA
Burlington	IA
Dubuque	IA
Iowa City	IA
Coralville	IA
Cedar Rapids	IA
Marion	IA
West Des Moines	IA
Marshalltown	IA
Muscatine	IA
Sioux City	IA
Ankeny	IA
Johnston	IA
Council Bluffs	IA
Davenport	IA
Bettendorf	IA
Ames	IA
Ottumwa	IA
Des Moines	IA
Fort Dodge	IA
Pittsburg	KS
Lawrence	KS
Hays	KS
Garden City	KS
Dodge City	KS
Junction City	KS
Overland Park	KS
Olathe	KS
Shawnee	KS
Lenexa	KS
Leawood	KS
Prairie Village	KS
Gardner	KS
Leavenworth	KS
Emporia	KS
Hutchinson	KS
Manhattan	KS
Salina	KS
Wichita	KS
Rockford	KS
Derby	KS
Liberal	KS
Topeka	KS
Kansas City	KS
Florence	KY
Ashland	KY
Hopkinsville	KY
Owensboro	KY
Lexington-Fayette	KY
Frankfort	KY
Elizabethtown	KY
Radcliff	KY
Henderson	KY
Jeffersontown	KY
Nicholasville	KY
Covington	KY
Independence	KY
Richmond	KY
Paducah	KY
Georgetown	KY
Bowling Green	KY
Prairieville	LA
Bossier City	LA
Shreveport	LA
Lake Charles	LA
Sulphur	LA
Baton Rouge	LA
Central	LA
New Iberia	LA
Metairie	LA
Kenner	LA
Marrero	LA
Terrytown	LA
Harvey	LA
Lafayette	LA
Ruston	LA
New Orleans	LA
Monroe	LA
Alexandria	LA
Laplace	LA
Slidell	LA
Hammond	LA
Houma	LA
Bayou Cane	LA
Lewiston	ME
Auburn	ME
Portland	ME
South Portland	ME
Brunswick	ME
Bangor	ME
Biddeford	ME
Sanford	ME
Cumberland	MD
Glen Burnie	MD
Severn	MD
Annapolis	MD
Odenton	MD
Severna Park	MD
Crofton	MD
Pasadena	MD
Arnold	MD
Baltimore	MD
Dundalk	MD
Towson	MD
Catonsville	MD
Woodlawn	MD
Essex	MD
Randallstown	MD
Owings Mills	MD
Pikesville	MD
Parkville	MD
Milford Mill	MD
Perry Hall	MD
Carney	MD
Reisterstown	MD
Middle River	MD
Lochearn	MD
Arbutus	MD
Cockeysville	MD
Eldersburg	MD
Waldorf	MD
Frederick	MD
Bel Air South	MD
Bel Air North	MD
Edgewood	MD
Columbia	MD
Ellicott City	MD
Ilchester	MD
North Laurel	MD
Germantown	MD
Silver Spring	MD
Gaithersburg	MD
Rockville	MD
Bethesda	MD
Aspen Hill	MD
Wheaton	MD
North Bethesda	MD
Potomac	MD
Olney	MD
Montgomery Village	MD
Fairland	MD
North Potomac	MD
Bowie	MD
Clinton	MD
Chillum	MD
College Park	MD
Laurel	MD
South Laurel	MD
Greenbelt	MD
Suitland	MD
Fort Washington	MD
Landover	MD
Langley Park	MD
Hagerstown	MD
Salisbury	MD
Barnstable Town	MA
Falmouth	MA
Yarmouth	MA
Sandwich	MA
Pittsfield	MA
New Bedford	MA
Fall River	MA
Taunton	MA
Attleboro	MA
Dartmouth	MA
North Attleborough	MA
Easton	MA
Mansfield	MA
Lynn	MA
Lawrence	MA
Haverhill	MA
Peabody	MA
Methuen Town	MA
Salem	MA
Beverly	MA
Andover	MA
Gloucester	MA
North Andover	MA
Saugus	MA
Danvers	MA
Saugus (CDP)	MA
Danvers (CDP)	MA
Marblehead	MA
Marblehead (CDP)	MA
Springfield	MA
Chicopee	MA
Westfield	MA
Holyoke	MA
Agawam Town	MA
West Springfield Town	MA
Ludlow	MA
Amherst	MA
Northampton	MA
Lowell	MA
Cambridge	MA
Newton	MA
Somerville	MA
Framingham	MA
Framingham (CDP)	MA
Waltham	MA
Malden	MA
Medford	MA
Everett	MA
Arlington	MA
Arlington (CDP)	MA
Billerica	MA
Marlborough	MA
Woburn	MA
Natick	MA
Chelmsford	MA
Watertown Town	MA
Lexington	MA
Lexington (CDP)	MA
Dracut	MA
Tewksbury	MA
Melrose	MA
Wakefield	MA
Burlington	MA
Wakefield (CDP)	MA
Reading	MA
Belmont	MA
Burlington (CDP)	MA
Reading (CDP)	MA
Belmont (CDP)	MA
Westford	MA
Acton	MA
Wilmington	MA
Wilmington (CDP)	MA
Winchester	MA
Stoneham	MA
Winchester (CDP)	MA
Stoneham (CDP)	MA
Quincy	MA
Brookline	MA
Brookline (CDP)	MA
Weymouth Town	MA
Braintree Town	MA
Randolph	MA
Franklin Town	MA
Randolph (CDP)	MA
Needham	MA
Needham (CDP)	MA
Norwood	MA
Wellesley	MA
Wellesley (CDP)	MA
Norwood (CDP)	MA
Stoughton	MA
Milton	MA
Milton (CDP)	MA
Dedham	MA
Dedham (CDP)	MA
Walpole	MA
Canton	MA
Brockton	MA
Plymouth	MA
Bridgewater	MA
Marshfield	MA
Middleborough	MA
Hingham	MA
Wareham	MA
Boston	MA
Revere	MA
Chelsea	MA
Worcester	MA
Leominster	MA
Fitchburg	MA
Shrewsbury	MA
Milford	MA
Milford (CDP)	MA
Gardner	MA
Bay City	MI
Midland	MI
Battle Creek	MI
East Lansing	MI
Lansing	MI
Delta	MI
Waverly	MI
Flint	MI
Grand Blanc (Charter Township)	MI
Flint (Charter Township)	MI
Burton	MI
Mount Morris (Township)	MI
Genesee	MI
Meridian	MI
Delhi	MI
Holt	MI
Okemos	MI
Haslett	MI
Mount Pleasant	MI
Jackson	MI
Blackman	MI
Summit	MI
Kalamazoo	MI
Portage	MI
Oshtemo	MI
Kalamazoo (Charter Township)	MI
Grand Rapids	MI
Wyoming	MI
Kentwood	MI
Plainfield	MI
Forest Hills	MI
Gaines	MI
Walker	MI
Byron	MI
Adrian	MI
Hamburg	MI
Genoa	MI
Warren	MI
Sterling Heights	MI
Clinton	MI
Macomb	MI
Shelby	MI
St. Clair Shores	MI
Roseville	MI
Chesterfield	MI
Eastpointe	MI
Washington	MI
Harrison	MI
Marquette	MI
Bedford	MI
Monroe	MI
Muskegon	MI
Norton Shores	MI
Troy	MI
Farmington Hills	MI
Rochester Hills	MI
Southfield	MI
Waterford	MI
West Bloomfield	MI
Pontiac	MI
Royal Oak	MI
Novi	MI
Commerce	MI
Bloomfield	MI
Orion	MI
Independence	MI
White Lake	MI
Madison Heights	MI
Oak Park	MI
Auburn Hills	MI
Oxford (Charter Township)	MI
Birmingham	MI
Ferndale	MI
Georgetown	MI
Holland (Charter Township)	MI
Allendale (Charter Township)	MI
Holland	MI
Saginaw	MI
Saginaw (Charter Township)	MI
Port Huron	MI
Ann Arbor	MI
Ypsilanti (Charter Township)	MI
Pittsfield	MI
Scio	MI
Detroit	MI
Dearborn	MI
Livonia	MI
Canton	MI
Westland	MI
Taylor	MI
Dearborn Heights	MI
Redford	MI
Lincoln Park	MI
Brownstown	MI
Southgate	MI
Northville (Township)	MI
Van Buren	MI
Allen Park	MI
Plymouth (Charter Township)	MI
Garden City	MI
Wyandotte	MI
Inkster	MI
Romulus	MI
Hamtramck	MI
Coon Rapids	MN
Andover	MN
Fridley	MN
Ramsey	MN
Lino Lakes	MN
Blaine	MN
St. Cloud	MN
Chaska	MN
Moorhead	MN
Eagan	MN
Burnsville	MN
Lakeville	MN
Apple Valley	MN
Inver Grove Heights	MN
Rosemount	MN
Farmington	MN
South St. Paul	MN
Northfield	MN
Hastings	MN
Minneapolis	MN
Bloomington	MN
Brooklyn Park	MN
Plymouth	MN
Maple Grove	MN
Eden Prairie	MN
Minnetonka	MN
Edina	MN
St. Louis Park	MN
Richfield	MN
Brooklyn Center	MN
Champlin	MN
Crystal	MN
Golden Valley	MN
New Hope	MN
Chanhassen	MN
Mankato	MN
Austin	MN
Rochester	MN
St. Paul	MN
Maplewood	MN
Roseville	MN
Shoreview	MN
New Brighton	MN
White Bear Lake	MN
Faribault	MN
Shakopee	MN
Savage	MN
Prior Lake	MN
Elk River	MN
Duluth	MN
Owatonna	MN
Woodbury	MN
Cottage Grove	MN
Oakdale	MN
Winona	MN
Southaven	MS
Olive Branch	MS
Horn Lake	MS
Gulfport	MS
Biloxi	MS
Clinton	MS
Pascagoula	MS
Oxford	MS
Hattiesburg	MS
Meridian	MS
Tupelo	MS
Columbus	MS
Madison	MS
Ridgeland	MS
Starkville	MS
Pearl	MS
Brandon	MS
Jackson	MS
Vicksburg	MS
Greenville	MS
Columbia	MO
St. Joseph	MO
Belton	MO
Raymore	MO
Lee's Summit	MO
Kansas City	MO
Nixa	MO
Springfield	MO
Liberty	MO
Gladstone	MO
Jefferson City	MO
Blue Springs	MO
Raytown	MO
Grandview	MO
Independence	MO
Arnold	MO
Joplin	MO
Sedalia	MO
Rolla	MO
Cape Girardeau	MO
O'Fallon	MO
St. Charles	MO
St. Peters	MO
Wentzville	MO
St. Louis	MO
Florissant	MO
Chesterfield	MO
Oakville	MO
Wildwood	MO
University City	MO
Ballwin	MO
Mehlville	MO
Kirkwood	MO
Maryland Heights	MO
Hazelwood	MO
Webster Groves	MO
Affton	MO
Ferguson	MO
Great Falls	MT
Kalispell	MT
Bozeman	MT
Helena	MT
Missoula	MT
Butte	MT
Billings	MT
Hastings	NE
Kearney	NE
Fremont	NE
Omaha	NE
Grand Island	NE
Lincoln	NE
North Platte	NE
Norfolk	NE
Columbus	NE
Bellevue	NE
Carson City	NV
Las Vegas	NV
Henderson	NV
North Las Vegas	NV
Paradise	NV
Sunrise Manor	NV
Spring Valley	NV
Enterprise	NV
Whitney	NV
Winchester	NV
Summerlin South	NV
Elko	NV
Pahrump	NV
Reno	NV
Sparks	NV
Keene	NH
Manchester	NH
Nashua	NH
Merrimack	NH
Hudson	NH
Bedford	NH
Concord	NH
Derry	NH
Salem	NH
Londonderry	NH
Derry (CDP)	NH
Portsmouth	NH
Dover	NH
Rochester	NH
Egg Harbor	NJ
Atlantic City	NJ
Galloway	NJ
Hamilton	NJ
Pleasantville	NJ
Hackensack	NJ
Teaneck	NJ
Fort Lee	NJ
Fair Lawn	NJ
Garfield	NJ
Englewood	NJ
Bergenfield	NJ
Paramus	NJ
Mahwah	NJ
Ridgewood	NJ
Cliffside Park	NJ
Lodi	NJ
Lyndhurst	NJ
Palisades Park	NJ
Elmwood Park	NJ
Evesham	NJ
Mount Laurel	NJ
Willingboro	NJ
Pemberton (Township)	NJ
Medford	NJ
Burlington (Township)	NJ
Moorestown	NJ
Camden	NJ
Cherry Hill	NJ
Gloucester	NJ
Winslow	NJ
Pennsauken	NJ
Voorhees	NJ
Lower	NJ
Vineland	NJ
Millville	NJ
Bridgeton	NJ
Newark	NJ
East Orange	NJ
Irvington	NJ
Bloomfield	NJ
West Orange	NJ
Montclair	NJ
Belleville	NJ
City of Orange	NJ
Livingston	NJ
Nutley	NJ
Maplewood	NJ
Millburn	NJ
Washington	NJ
Monroe	NJ
Deptford	NJ
West Deptford	NJ
Jersey City	NJ
Union City	NJ
Bayonne	NJ
North Bergen	NJ
Hoboken	NJ
West New York	NJ
Kearny	NJ
Raritan	NJ
Hamilton	NJ
Trenton	NJ
Ewing	NJ
Lawrence	NJ
Princeton	NJ
West Windsor	NJ
East Windsor	NJ
Edison	NJ
Woodbridge (Township)	NJ
Old Bridge (Township)	NJ
Piscataway	NJ
New Brunswick	NJ
Perth Amboy	NJ
East Brunswick	NJ
South Brunswick	NJ
Sayreville	NJ
Monroe	NJ
North Brunswick	NJ
South Plainfield	NJ
Carteret	NJ
Plainsboro	NJ
Old Bridge	NJ
Woodbridge	NJ
Middletown	NJ
Howell	NJ
Marlboro	NJ
Manalapan	NJ
Freehold (Township)	NJ
Long Branch	NJ
Neptune	NJ
Ocean	NJ
Wall	NJ
Hazlet	NJ
Parsippany-Troy Hills	NJ
Mount Olive	NJ
Randolph	NJ
Rockaway (Township)	NJ
Roxbury	NJ
Morris	NJ
Montville	NJ
Jefferson	NJ
Lakewood (Township)	NJ
Toms River (Township)	NJ
Toms River	NJ
Brick	NJ
Jackson	NJ
Lakewood	NJ
Manchester	NJ
Berkeley	NJ
Lacey	NJ
Stafford	NJ
Barnegat (Township)	NJ
Little Egg Harbor	NJ
Paterson	NJ
Clifton	NJ
Passaic	NJ
Wayne	NJ
West Milford	NJ
Franklin	NJ
Bridgewater	NJ
Hillsborough	NJ
Bernards	NJ
Somerset	NJ
Montgomery	NJ
North Plainfield	NJ
Vernon	NJ
Elizabeth	NJ
Union	NJ
Plainfield	NJ
Linden	NJ
Westfield	NJ
Rahway	NJ
Scotch Plains	NJ
Cranford	NJ
Summit	NJ
Hillside	NJ
Roselle	NJ
Albuquerque	NM
South Valley	NM
Roswell	NM
Clovis	NM
Las Cruces	NM
Carlsbad	NM
Hobbs	NM
Gallup	NM
Alamogordo	NM
Farmington	NM
Rio Rancho	NM
Santa Fe	NM
Albany	NY
Colonie (Town)	NY
Guilderland	NY
Bethlehem	NY
Union	NY
Binghamton	NY
Vestal	NY
Auburn	NY
Jamestown	NY
Elmira	NY
Poughkeepsie (Town)	NY
Poughkeepsie	NY
East Fishkill	NY
Wappinger	NY
Fishkill (Town)	NY
Hyde Park	NY
Buffalo	NY
Amherst	NY
Cheektowaga	NY
Cheektowaga (CDP)	NY
Tonawanda (Town)	NY
Tonawanda (CDP)	NY
Hamburg (Town)	NY
West Seneca	NY
West Seneca (CDP)	NY
Lancaster (Town)	NY
Clarence	NY
Orchard Park (Town)	NY
Grand Island	NY
Watertown	NY
Le Ray	NY
Rochester	NY
Greece	NY
Irondequoit (CDP)	NY
Irondequoit	NY
Perinton	NY
Webster (Town)	NY
Henrietta	NY
Penfield	NY
Brighton (CDP)	NY
Brighton	NY
Pittsford (Town)	NY
Chili	NY
Gates	NY
Ogden	NY
Hempstead (Town)	NY
Oyster Bay	NY
North Hempstead	NY
Hempstead	NY
Levittown	NY
Freeport	NY
Hicksville	NY
Valley Stream	NY
East Meadow	NY
Elmont	NY
Long Beach	NY
Franklin Square	NY
Oceanside	NY
Glen Cove	NY
Plainview	NY
Baldwin	NY
Uniondale	NY
Rockville Centre	NY
Garden City	NY
Massapequa	NY
Merrick	NY
North Bellmore	NY
Niagara Falls	NY
North Tonawanda	NY
Lockport	NY
Lockport (Town)	NY
Utica	NY
Rome	NY
New Hartford (Town)	NY
Syracuse	NY
Clay	NY
Salina	NY
Manlius (Town)	NY
Cicero	NY
De Witt	NY
Camillus (Town)	NY
Onondaga	NY
Lysander	NY
Monroe (Town)	NY
Warwick (Town)	NY
Newburgh (Town)	NY
Wallkill	NY
Newburgh	NY
Middletown	NY
New Windsor	NY
Montgomery (Town)	NY
Kiryas Joel	NY
Carmel	NY
Troy	NY
New York City	NY
Ramapo	NY
Clarkstown	NY
Orangetown	NY
Haverstraw (Town)	NY
New City	NY
Spring Valley	NY
Monsey	NY
Clifton Park	NY
Saratoga Springs	NY
Halfmoon	NY
Schenectady	NY
Glenville	NY
Rotterdam	NY
Niskayuna	NY
Rotterdam (CDP)	NY
Brookhaven	NY
Islip	NY
Babylon (Town)	NY
Huntington	NY
Smithtown	NY
Brentwood	NY
Southampton (Town)	NY
West Babylon	NY
Coram	NY
Central Islip	NY
Commack	NY
Huntington Station	NY
Riverhead	NY
Centereach	NY
Bay Shore	NY
Holbrook	NY
West Islip	NY
Deer Park	NY
Lindenhurst	NY
Dix Hills	NY
Smithtown (CDP)	NY
Shirley	NY
Medford	NY
Copiague	NY
Southold	NY
East Patchogue	NY
East Hampton (Town)	NY
Hauppauge	NY
Selden	NY
Holtsville	NY
Ithaca	NY
Ithaca (Town)	NY
Kingston	NY
Queensbury	NY
Yonkers	NY
Greenburgh	NY
New Rochelle	NY
Mount Vernon	NY
White Plains	NY
Rye (Town)	NY
Mount Pleasant	NY
Cortlandt	NY
Ossining (Town)	NY
Yorktown	NY
Eastchester	NY
Mamaroneck (Town)	NY
Port Chester	NY
Harrison	NY
Harrison (Town)	NY
Ossining	NY
Peekskill	NY
Somers	NY
Burlington	NC
Asheville	NC
Concord	NC
Hickory	NC
Cary	NC
Shelby	NC
New Bern	NC
Havelock	NC
Fayetteville	NC
Thomasville	NC
High Point	NC
Chapel Hill	NC
Durham	NC
Raleigh	NC
Morrisville	NC
Rocky Mount	NC
Winston-Salem	NC
Kernersville	NC
Wake Forest	NC
Gastonia	NC
Greensboro	NC
Mooresville	NC
Statesville	NC
Sanford	NC
Kinston	NC
Charlotte	NC
Huntersville	NC
Matthews	NC
Cornelius	NC
Wilmington	NC
Jacksonville	NC
Carrboro	NC
Greenville	NC
Asheboro	NC
Lumberton	NC
Salisbury	NC
Kannapolis	NC
Indian Trail	NC
Monroe	NC
Mint Hill	NC
Apex	NC
Holly Springs	NC
Garner	NC
Fuquay-Varina	NC
Goldsboro	NC
Wilson	NC
Bismarck	ND
Fargo	ND
West Fargo	ND
Grand Forks	ND
Mandan	ND
Dickinson	ND
Minot	ND
Williston	ND
Lima	OH
Ashland	OH
Ashtabula (Township)	OH
Athens (Township)	OH
Athens	OH
West Chester	OH
Hamilton	OH
Liberty	OH
Oxford (Township)	OH
Fairfield (Township)	OH
Oxford	OH
Fairfield	OH
Middletown	OH
Springfield	OH
Union	OH
Miami	OH
Batavia (Township)	OH
Cleveland	OH
Parma	OH
Lakewood	OH
Euclid	OH
Cleveland Heights	OH
Strongsville	OH
Westlake	OH
North Olmsted	OH
North Royalton	OH
Garfield Heights	OH
Shaker Heights	OH
Solon	OH
Maple Heights	OH
South Euclid	OH
Rocky River	OH
Parma Heights	OH
Delaware	OH
Liberty	OH
Orange	OH
Genoa	OH
Westerville	OH
Columbus	OH
Dublin	OH
Sandusky	OH
Violet	OH
Lancaster	OH
Jackson	OH
Grove City	OH
Mifflin	OH
Norwich	OH
Upper Arlington	OH
Gahanna	OH
Hilliard	OH
Truro	OH
Madison	OH
Reynoldsburg	OH
Beavercreek (Township)	OH
Beavercreek	OH
Bath	OH
Fairborn	OH
Xenia	OH
Kettering	OH
Centerville	OH
Cincinnati	OH
Colerain	OH
Green	OH
Anderson	OH
Springfield	OH
Delhi	OH
Findlay	OH
Mentor	OH
Willoughby	OH
Painesville (Township)	OH
Newark	OH
Lorain	OH
Elyria	OH
North Ridgeville	OH
Avon Lake	OH
Avon	OH
Toledo	OH
Sylvania (Township)	OH
Springfield	OH
Oregon	OH
Boardman (Township)	OH
Austintown (Township)	OH
Boardman	OH
Austintown	OH
Marion (Township)	OH
Marion	OH
Brunswick	OH
Medina	OH
Wadsworth	OH
Concord	OH
Troy	OH
Piqua	OH
Huber Heights	OH
Dayton	OH
Washington	OH
Miami	OH
Riverside	OH
Trotwood	OH
Harrison	OH
Miamisburg	OH
Zanesville	OH
Kent	OH
Mansfield	OH
Scioto	OH
Chillicothe	OH
Portsmouth	OH
Clinton	OH
Sidney	OH
Canton	OH
Plain	OH
Jackson	OH
Massillon	OH
Lake	OH
Perry	OH
Alliance	OH
Akron	OH
Cuyahoga Falls	OH
Stow	OH
Barberton	OH
Green	OH
Hudson	OH
Warren	OH
Weathersfield	OH
Liberty	OH
Youngstown	OH
Paris	OH
Marysville	OH
Deerfield	OH
Mason	OH
Clear Creek	OH
Franklin (Township)	OH
Hamilton	OH
Lebanon	OH
Wooster	OH
Bowling Green	OH
Perrysburg	OH
Yukon	OK
Mustang	OK
Oklahoma City	OK
Ardmore	OK
Norman	OK
Moore	OK
Lawton	OK
Sapulpa	OK
Enid	OK
Ponca City	OK
Muskogee	OK
Edmond	OK
Midwest City	OK
Del City	OK
Stillwater	OK
Shawnee	OK
Owasso	OK
Tulsa	OK
Duncan	OK
Jenks	OK
Broken Arrow	OK
Bixby	OK
Bartlesville	OK
Corvallis	OR
Albany	OR
Oregon City	OR
West Linn	OR
Milwaukie	OR
Portland	OR
Lake Oswego	OR
Tualatin	OR
Wilsonville	OR
Bend	OR
Redmond	OR
Roseburg	OR
Medford	OR
Ashland	OR
Grants Pass	OR
Klamath Falls	OR
Eugene	OR
Springfield	OR
Keizer	OR
Woodburn	OR
Salem	OR
Gresham	OR
Hillsboro	OR
Beaverton	OR
Aloha	OR
Tigard	OR
Forest Grove	OR
Bethany	OR
McMinnville	OR
Newberg	OR
Pittsburgh	PA
Penn Hills	PA
Mount Lebanon	PA
Bethel Park	PA
Ross	PA
McCandless	PA
Shaler	PA
Monroeville	PA
Plum	PA
Moon	PA
Allison Park	PA
West Mifflin	PA
Reading	PA
Spring	PA
Exeter	PA
Muhlenberg	PA
Altoona	PA
Bensalem	PA
Bristol (Township)	PA
Levittown	PA
Middletown	PA
Northampton	PA
Falls	PA
Lower Makefield	PA
Warminster	PA
Warrington	PA
Buckingham	PA
Cranberry	PA
State College	PA
Tredyffrin	PA
West Goshen	PA
Hampden	PA
East Pennsboro	PA
Harrisburg	PA
Lower Paxton	PA
Derry	PA
Susquehanna	PA
Swatara	PA
Upper Darby	PA
Haverford	PA
Chester	PA
Radnor	PA
Ridley	PA
Drexel Hill	PA
Springfield	PA
Marple	PA
Erie	PA
Millcreek	PA
Chambersburg	PA
Scranton	PA
Lancaster	PA
Manheim (Township)	PA
East Hempfield	PA
Manor	PA
New Castle	PA
Lebanon	PA
Allentown	PA
Lower Macungie	PA
Whitehall	PA
Upper Macungie	PA
Bethlehem	PA
Wilkes-Barre	PA
Hazleton	PA
Williamsport	PA
Coolbaugh	PA
Lower Merion	PA
Abington	PA
Cheltenham	PA
Norristown	PA
Upper Merion	PA
Horsham (Township)	PA
Upper Dublin	PA
Lower Providence	PA
Montgomery	PA
Upper Moreland	PA
Upper Providence	PA
Pottstown	PA
Easton	PA
Bethlehem (Township)	PA
Palmer	PA
Philadelphia	PA
Peters	PA
Hempfield	PA
North Huntingdon	PA
Unity	PA
Murrysville	PA
York	PA
York (Township)	PA
Springettsbury	PA
Dover (Township)	PA
Bristol	RI
Warwick	RI
Coventry	RI
West Warwick	RI
Newport	RI
Providence	RI
Cranston	RI
Pawtucket	RI
East Providence	RI
Woonsocket	RI
Cumberland	RI
North Providence	RI
Johnston	RI
Lincoln	RI
Smithfield	RI
South Kingstown	RI
North Kingstown	RI
Westerly	RI
Aiken	SC
North Augusta	SC
Anderson	SC
Easley	SC
Hilton Head Island	SC
Hanahan	SC
Charleston	SC
Goose Creek	SC
Mount Pleasant	SC
North Charleston	SC
Summerville	SC
Florence	SC
Greenville	SC
Mauldin	SC
Taylors	SC
Simpsonville	SC
Greer	SC
Greenwood	SC
Myrtle Beach	SC
Conway	SC
Socastee	SC
Lexington	SC
Columbia	SC
St. Andrews	SC
Spartanburg	SC
Sumter	SC
Rock Hill	SC
Brookings	SD
Aberdeen	SD
Watertown	SD
Sioux Falls	SD
Rapid City	SD
Shelbyville	TN
Maryville	TN
Cleveland	TN
Johnson City	TN
Nashville	TN
Chattanooga	TN
East Ridge	TN
Kingsport	TN
Morristown	TN
Knoxville	TN
Farragut	TN
Jackson	TN
Columbia	TN
Clarksville	TN
Cookeville	TN
Oak Ridge	TN
Murfreesboro	TN
La Vergne	TN
Smyrna	TN
Memphis	TN
Bartlett	TN
Collierville	TN
Germantown	TN
Bristol	TN
Hendersonville	TN
Gallatin	TN
Franklin	TN
Brentwood	TN
Spring Hill	TN
Mount Juliet	TN
Lebanon	TN
Lufkin	TX
Corpus Christi	TX
Killeen	TX
Temple	TX
Harker Heights	TX
Belton	TX
Fort Hood	TX
Copperas Cove	TX
Timberwood Park	TX
Converse	TX
Schertz	TX
San Antonio	TX
Cibolo	TX
Texarkana	TX
Lake Jackson	TX
Alvin	TX
College Station	TX
Bryan	TX
San Marcos	TX
Brownsville	TX
Harlingen	TX
San Benito	TX
McKinney	TX
Allen	TX
Murphy	TX
Richardson	TX
Sachse	TX
Plano	TX
Frisco	TX
Carrollton	TX
Canyon Lake	TX
New Braunfels	TX
Irving	TX
DeSoto	TX
Duncanville	TX
Lancaster	TX
Farmers Branch	TX
Balch Springs	TX
University Park	TX
Denton	TX
The Colony	TX
Little Elm	TX
Corinth	TX
Lewisville	TX
Coppell	TX
West Odessa	TX
El Paso	TX
Socorro	TX
Waxahachie	TX
Midlothian	TX
Cedar Hill	TX
Stephenville	TX
Sugar Land	TX
Rosenberg	TX
Fresno	TX
Missouri City	TX
Mission Bend	TX
Pearland	TX
Houston	TX
Galveston	TX
Texas City	TX
League City	TX
Friendswood	TX
Sherman	TX
Denison	TX
Seguin	TX
Plainview	TX
Pasadena	TX
Atascocita	TX
Spring	TX
Channelview	TX
La Porte	TX
Deer Park	TX
Cloverleaf	TX
Baytown	TX
The Woodlands	TX
Marshall	TX
Longview	TX
Kyle	TX
Austin	TX
McAllen	TX
Edinburg	TX
Mission	TX
Pharr	TX
Weslaco	TX
San Juan	TX
Big Spring	TX
Greenville	TX
Beaumont	TX
Cleburne	TX
Burleson	TX
Mansfield	TX
Abilene	TX
Mesquite	TX
Kerrville	TX
Kingsville	TX
Paris	TX
Lubbock	TX
Midland	TX
Eagle Pass	TX
Waco	TX
Odessa	TX
Conroe	TX
Nacogdoches	TX
Corsicana	TX
Port Arthur	TX
Weatherford	TX
Fort Worth	TX
Amarillo	TX
Rockwall	TX
Garland	TX
Wylie	TX
Rowlett	TX
Dallas	TX
Tyler	TX
Arlington	TX
North Richland Hills	TX
Euless	TX
Bedford	TX
Keller	TX
Haltom City	TX
Hurst	TX
Colleyville	TX
Watauga	TX
Benbrook	TX
Saginaw	TX
Flower Mound	TX
Southlake	TX
Grapevine	TX
Grand Prairie	TX
San Angelo	TX
Del Rio	TX
Victoria	TX
Huntsville	TX
Laredo	TX
Wichita Falls	TX
Georgetown	TX
Hutto	TX
Brushy Creek	TX
Round Rock	TX
Cedar Park	TX
Pflugerville	TX
Leander	TX
Logan	UT
Layton	UT
Bountiful	UT
Clearfield	UT
Kaysville	UT
Syracuse	UT
Farmington	UT
Clinton	UT
Cedar City	UT
Salt Lake City	UT
West Valley City	UT
West Jordan	UT
Sandy	UT
South Jordan	UT
Millcreek	UT
Taylorsville	UT
Murray	UT
Riverton	UT
Kearns	UT
Cottonwood Heights	UT
Midvale	UT
Holladay	UT
Herriman	UT
Magna	UT
South Salt Lake	UT
Draper	UT
Tooele	UT
Provo	UT
Orem	UT
Lehi	UT
Pleasant Grove	UT
Spanish Fork	UT
Springville	UT
American Fork	UT
Eagle Mountain	UT
Saratoga Springs	UT
St. George	UT
Washington	UT
Ogden	UT
Roy	UT
Burlington	VT
Essex	VT
Alexandria	VA
Arlington	VA
Charlottesville	VA
Chesapeake	VA
Chester	VA
Danville	VA
Fairfax	VA
Centreville	VA
Reston	VA
McLean	VA
Annandale	VA
Burke	VA
Oakton	VA
Fair Oaks	VA
Springfield	VA
West Falls Church	VA
Bailey's Crossroads	VA
Chantilly	VA
West Springfield	VA
Lincolnia	VA
Tysons Corner	VA
Herndon	VA
Fredericksburg	VA
Hampton	VA
Mechanicsville	VA
Harrisonburg	VA
Tuckahoe	VA
Short Pump	VA
Hopewell	VA
Leesburg	VA
Ashburn	VA
Sterling	VA
South Riding	VA
Lynchburg	VA
Manassas	VA
Blacksburg	VA
Christiansburg	VA
Newport News	VA
Norfolk	VA
Petersburg	VA
Portsmouth	VA
Dale City	VA
Lake Ridge	VA
Linton Hall	VA
Marumsco	VA
Richmond	VA
Roanoke	VA
Cave Spring	VA
Salem	VA
Staunton	VA
Suffolk	VA
Virginia Beach	VA
Waynesboro	VA
Winchester	VA
Kennewick	WA
Richland	WA
Wenatchee	WA
Vancouver	WA
Camas	WA
Orchards	WA
Salmon Creek	WA
Longview	WA
Pasco	WA
Moses Lake	WA
Oak Harbor	WA
Seattle	WA
Bellevue	WA
Kent	WA
Renton	WA
Federal Way	WA
Kirkland	WA
Redmond	WA
Shoreline	WA
Sammamish	WA
Burien	WA
Issaquah	WA
Des Moines	WA
SeaTac	WA
Maple Valley	WA
Mercer Island	WA
Cottage Lake	WA
Kenmore	WA
Union Hill-Novelty Hill	WA
Auburn	WA
Bremerton	WA
Bainbridge Island	WA
Silverdale	WA
Tacoma	WA
Lakewood	WA
South Hill	WA
Puyallup	WA
Parkland	WA
University Place	WA
Spanaway	WA
Graham	WA
Mount Vernon	WA
Everett	WA
Marysville	WA
Edmonds	WA
Lynnwood	WA
Lake Stevens	WA
Silver Firs	WA
Mukilteo	WA
Mountlake Terrace	WA
Eastmont	WA
Mill Creek	WA
Bothell	WA
Spokane	WA
Spokane Valley	WA
Olympia	WA
Lacey	WA
Walla Walla	WA
Bellingham	WA
Pullman	WA
Yakima	WA
Huntington	WV
Charleston	WV
Wheeling	WV
Morgantown	WV
Parkersburg	WV
Green Bay	WI
De Pere	WI
Madison	WI
Sun Prairie	WI
Fitchburg	WI
Watertown	WI
Superior	WI
Eau Claire	WI
Fond du Lac	WI
Kenosha	WI
Pleasant Prairie	WI
La Crosse	WI
Manitowoc	WI
Wausau	WI
West Allis	WI
Wauwatosa	WI
Greenfield	WI
Franklin	WI
Oak Creek	WI
South Milwaukee	WI
Milwaukee	WI
Grand Chute	WI
Appleton	WI
Mequon	WI
Stevens Point	WI
Racine	WI
Mount Pleasant	WI
Caledonia	WI
Janesville	WI
Beloit	WI
Sheboygan	WI
West Bend	WI
Waukesha	WI
New Berlin	WI
Brookfield	WI
Menomonee Falls	WI
Muskego	WI
Oshkosh	WI
Neenah	WI
Laramie	WY
Gillette	WY
Cheyenne	WY
Casper	WY
Rock Springs	WY